TST = "countries/Test.txt"
PAM = "countries/Pandaemonium.txt"
SHE = "countries/Sheol.txt"
FRE = "countries/FreeMalebolge.txt"
GIL = "countries/GildedIsles.txt"
GOM = "countries/Gomorrah.txt"
SOD = "countries/Sodom.txt"
ANT = "countries/AntaeusRevolt.txt"
ZEB = "countries/Zeboiim.txt"
ADM = "countries/Admah.txt"
BES = "countries/Belshazzar.txt"
GAT = "countries/TheGates.txt"
CAB = "countries/Cambionia.txt"
DIS = "countries/Dis.txt"
KRO = "countries/Krokopeplos.txt"
LEM = "countries/Lemnos.txt"
SAM = "countries/SamaelHost.txt"
PEI = "countries/Peisithanatos.txt"
ATH = "countries/Atheos.txt"
HEN = "countries/Henosis.txt"
XAN = "countries/Xana.txt"
CAL = "countries/Camlann.txt"
TAM = "countries/Tam.txt"
VAN = "countries/Vanitas.txt"
ANO = "countries/Antonii.txt"
LEV = "countries/Levi.txt"
BUC = "countries/Bucoli.txt"
STU = "countries/Stupri.txt"
AUL = "countries/Auli.txt"
SUC = "countries/Succubus.txt"
INC = "countries/Incubus.txt"
BEA = "countries/Belladonnae.txt"
MAI = "countries/Maligenii.txt"
